//1 test maze
{1,1,1,1,1,1,1},
{1,3,0,0,0,0,1},
{1,2,2,0,2,2,1},
{1,0,0,0,0,0,1},
{1,4,1,1,1,1,1},

//2
{1,1,1,1,1,1,1,1,1,1,1,1,1,1,1,1,1,1,1,1},
{1,3,0,2,2,2,2,2,2,0,0,0,0,0,0,0,2,0,0,1},
{1,2,0,0,0,0,0,0,0,0,2,2,2,0,2,2,0,0,2,1},
{4,0,2,2,2,2,2,2,2,2,2,0,2,0,0,2,0,2,2,1},
{1,0,2,2,2,0,2,0,0,0,0,0,2,2,0,0,0,0,0,1},
{1,0,0,0,0,0,2,0,2,0,2,2,2,2,2,2,2,2,0,1},
{1,0,2,2,2,2,0,0,2,0,2,2,0,0,0,0,0,0,0,1},
{1,0,0,2,2,0,0,2,2,0,0,2,0,2,2,2,2,2,2,1},
{1,2,0,0,0,0,2,2,2,2,0,0,0,0,0,0,0,0,0,1},
{1,1,1,1,1,1,1,1,1,1,1,1,1,1,1,1,1,1,1,1}

//3
{1,1,1,1,1,1,1,1,1,1,1,1,1,1,1,1,1,1,1,1},
{1,2,0,2,2,2,0,0,0,0,2,2,2,2,2,2,2,3,0,1},
{1,2,0,2,0,2,0,2,2,0,0,0,0,2,0,0,2,2,0,1},
{1,2,0,2,0,2,0,0,2,2,2,2,0,2,2,0,0,0,0,1},
{1,2,0,0,2,2,0,0,0,0,0,2,0,0,2,0,2,2,2,1},
{1,2,2,0,0,0,0,2,2,2,0,2,0,0,2,0,0,0,0,1},
{1,0,2,2,2,0,2,2,0,0,0,2,2,0,2,0,0,2,0,1},
{1,0,0,0,2,0,0,0,2,0,0,0,2,0,0,2,2,2,0,1},
{1,2,2,2,2,2,2,0,2,2,2,2,2,2,0,0,0,0,0,1},
{1,1,1,1,1,1,1,4,1,1,1,1,1,1,1,1,1,1,1,1},

//4
{1,1,1,1,1,1,1,1,1,1,1,1,1,1,1,1,1,1,1,1},
{1,2,3,2,2,2,2,0,2,2,2,0,2,2,2,0,0,2,2,1},
{1,2,0,0,2,0,2,2,2,0,2,0,2,0,2,2,2,2,0,1},
{1,2,2,0,2,0,0,0,0,0,0,2,2,0,0,2,0,2,0,1},
{1,0,2,0,2,0,2,2,2,2,0,0,0,0,2,2,0,2,2,1},
{1,0,2,0,2,0,0,0,0,2,2,2,2,2,2,0,0,0,2,1},
{1,0,0,0,0,0,2,0,0,0,0,2,0,0,0,0,2,0,0,1},
{1,2,2,0,2,0,2,0,2,0,0,2,0,2,2,0,0,2,0,1},
{1,2,0,0,2,2,2,0,2,2,0,0,0,2,0,2,2,2,0,4},
{1,1,1,1,1,1,1,1,1,1,1,1,1,1,1,1,1,1,1,1},

//5
{1,1,1,1,1,1,1,1,1,1,4,1,1,1,1,1,1,1,1,1,1,1,1,1,1,1,1,1,1,1},
{1,3,2,2,0,0,0,2,2,2,0,0,0,0,0,2,2,0,0,0,0,0,0,0,0,0,2,0,0,1},
{1,0,0,0,2,2,0,0,0,0,2,2,2,2,0,0,0,0,2,2,2,2,2,2,2,0,2,2,0,1},
{1,2,2,0,2,0,2,0,2,0,2,2,0,0,0,2,2,2,0,0,0,0,0,2,0,0,2,0,0,1},
{1,0,0,0,2,0,2,0,2,0,0,2,0,2,2,2,0,0,0,2,0,2,0,0,0,2,0,0,2,1},
{1,0,2,2,2,0,0,0,0,2,0,2,0,0,0,2,2,2,2,2,0,2,2,2,2,2,0,2,2,1},
{1,0,0,0,2,2,2,2,0,2,0,2,2,2,0,0,0,0,2,2,0,0,0,0,0,0,0,0,0,1},
{1,2,2,0,0,0,2,0,0,2,0,0,2,2,2,0,2,0,0,0,2,2,2,2,2,2,2,2,0,1},
{1,0,2,2,2,0,0,0,2,2,2,0,0,2,0,0,2,0,2,0,0,0,2,2,0,0,0,2,0,1},
{1,0,2,0,2,0,2,2,2,2,2,2,0,2,0,2,2,0,2,0,2,0,0,2,0,2,0,0,2,1},
{1,0,0,0,2,2,2,0,2,2,0,0,0,2,2,2,2,2,2,0,2,2,0,2,0,2,2,0,2,1},
{1,0,2,0,0,0,0,0,2,0,0,2,2,2,0,0,0,0,2,2,0,0,0,2,0,0,2,0,0,1},
{1,0,2,2,0,2,2,2,0,0,2,0,0,0,0,2,2,0,0,2,0,2,2,2,0,2,2,2,0,1},
{1,0,2,0,0,0,0,2,0,2,2,0,2,2,2,2,2,2,0,2,0,2,0,0,0,2,0,0,0,1},
{1,0,2,2,2,0,2,2,0,2,2,0,2,0,0,0,0,2,0,2,0,0,0,2,2,0,0,2,0,1},
{1,0,2,0,0,0,2,0,0,2,0,0,2,0,2,2,0,0,0,0,2,2,0,2,0,0,2,2,0,1},
{1,0,2,0,2,2,2,0,2,0,0,2,2,0,2,2,2,2,2,0,0,2,2,2,0,2,0,0,0,1},
{1,0,2,0,0,2,2,0,2,0,2,2,0,0,0,2,0,0,0,2,0,0,2,0,0,2,0,2,2,1},
{1,0,2,2,0,0,0,0,0,0,2,0,0,2,0,0,0,2,0,2,2,0,0,0,2,2,0,0,0,1},
{1,1,1,1,1,1,1,1,1,1,1,1,1,1,1,1,1,1,1,1,1,1,1,1,1,1,1,1,1,1},

//6
{1,1,1,1,1,1,1,1,1,1,1,1,1,1,1,1,1,1,1,1,1,1,1,1,1,1,1,1,1,1,1,1,1,1,1,1,1,1,1,1,1,1,1,1,1,1,1,1,1,1},
{1,3,2,0,0,0,0,0,0,0,2,0,0,0,0,0,0,0,0,0,0,0,2,0,0,0,0,0,0,0,2,0,0,0,0,2,2,2,0,0,0,2,0,0,0,0,0,2,0,1},
{1,0,2,0,2,2,2,0,2,0,2,2,2,2,2,2,0,2,2,2,2,0,0,2,2,2,2,0,2,0,0,0,2,2,0,0,0,0,0,2,0,2,2,2,2,2,0,0,0,1},
{1,0,2,0,2,2,2,0,2,0,0,0,2,2,2,0,0,2,0,2,2,2,0,0,0,2,2,0,2,2,2,2,2,2,2,2,2,2,2,2,0,0,0,0,0,2,2,0,2,1},
{1,0,2,0,2,2,0,0,2,2,2,0,0,2,0,0,2,2,0,0,0,0,2,2,0,0,0,0,2,0,0,0,0,0,2,2,0,0,0,2,2,2,2,2,0,0,2,0,2,1},
{1,0,2,0,2,0,0,2,2,0,2,2,0,0,0,2,2,0,0,2,2,0,0,2,2,2,2,2,2,0,2,0,2,0,0,0,0,2,0,0,2,2,0,2,2,0,2,0,0,1},
{1,0,2,2,0,0,2,2,2,0,2,2,2,2,2,0,0,0,2,2,2,2,0,0,0,0,2,0,0,0,2,0,2,2,2,2,2,2,2,0,0,0,0,2,0,0,2,2,0,1},
{1,0,0,2,0,2,0,0,0,0,2,0,0,0,2,0,2,0,0,0,2,0,0,2,2,2,0,0,2,2,2,0,2,0,0,0,0,0,0,0,2,2,2,0,0,2,2,2,0,1},
{1,2,0,0,0,2,0,2,2,0,0,0,2,0,2,2,2,0,2,0,2,2,2,2,0,0,0,2,2,0,2,0,2,2,0,2,0,2,2,2,0,0,2,0,2,2,2,0,0,1},
{1,2,2,2,2,2,0,2,2,2,2,2,2,0,0,0,2,2,2,0,2,0,0,0,0,2,2,2,0,0,2,0,0,2,0,2,0,2,0,2,0,2,2,0,2,0,0,0,2,1},
{1,0,0,0,0,0,0,2,2,0,0,0,0,2,2,0,0,0,2,0,2,2,0,2,2,2,0,0,0,2,2,2,0,2,2,2,0,0,0,2,0,0,0,0,2,2,2,0,2,1},
{1,0,2,2,0,2,2,0,0,0,2,2,0,0,2,0,2,0,0,0,2,0,0,2,0,2,0,2,0,2,0,2,0,0,0,2,2,2,2,2,0,2,2,2,2,0,0,0,0,1},
{1,0,0,2,0,2,2,0,2,2,2,2,2,0,2,0,2,2,0,2,2,0,2,2,0,2,0,2,0,0,0,2,0,2,0,2,2,0,0,0,0,2,2,0,2,0,2,2,2,1},
{1,2,0,2,0,0,0,0,2,0,0,0,2,0,2,2,2,2,0,2,0,0,2,2,0,0,0,0,2,0,2,2,0,2,0,2,0,0,2,2,2,0,0,0,2,0,0,0,0,1},
{1,0,0,2,2,2,2,2,2,0,2,2,2,0,0,0,0,2,0,2,0,2,2,0,0,2,2,0,2,0,0,2,0,2,0,0,0,2,2,2,2,0,2,0,2,2,2,0,2,1},
{1,0,2,2,2,0,0,0,2,0,0,0,0,2,2,0,2,2,0,2,0,0,2,2,2,2,0,0,2,2,0,0,2,2,2,2,2,0,0,0,0,0,2,0,0,2,2,0,2,1},
{1,0,2,2,0,0,2,0,2,2,2,2,0,2,2,0,0,2,0,2,2,0,0,0,0,2,0,2,0,2,2,0,0,0,2,0,2,2,2,0,2,2,2,2,0,0,0,0,2,1},
{1,0,0,0,0,2,2,0,0,2,2,0,0,0,0,2,0,0,2,2,2,2,2,2,0,0,0,2,0,2,2,2,2,0,0,0,2,2,0,0,2,0,0,2,2,2,2,0,0,1},
{1,2,2,2,2,2,2,2,0,0,0,0,2,2,0,2,2,0,2,0,0,0,0,2,2,2,2,2,0,0,0,0,0,2,2,0,0,0,0,2,2,2,0,0,0,0,2,2,0,1},
{1,0,0,0,0,0,0,2,2,2,2,2,2,2,0,2,0,0,0,0,2,2,0,0,2,2,0,0,0,2,2,2,0,2,2,2,2,2,2,2,2,0,0,2,2,0,2,2,0,1},
{1,2,0,2,2,2,2,2,0,0,0,2,0,0,0,2,2,2,2,2,2,2,2,0,0,0,0,2,2,2,0,0,0,0,0,0,0,0,2,0,0,0,2,0,2,0,0,0,0,1},
{1,0,0,2,0,0,0,0,0,2,0,2,0,2,2,0,0,0,0,0,0,0,2,0,2,2,2,2,0,0,0,2,2,2,2,2,2,2,0,0,2,2,2,0,2,2,2,2,2,1},
{1,0,2,2,0,2,2,2,2,2,0,2,0,0,2,2,2,2,2,2,2,0,2,0,2,2,0,0,0,2,2,2,2,0,0,0,0,0,0,2,2,2,0,0,0,2,2,2,0,1},
{1,0,0,0,0,2,0,0,0,2,0,2,2,0,0,2,0,0,2,0,2,0,2,2,2,0,0,2,2,0,0,0,0,0,2,2,2,2,2,2,0,0,0,2,0,0,0,0,0,1},
{1,2,2,0,2,2,0,2,2,2,0,0,0,2,0,2,2,0,0,0,2,0,2,0,0,0,2,2,0,0,2,2,2,2,2,2,0,0,0,2,2,0,2,2,2,0,2,2,0,1},
{1,2,0,0,2,0,0,0,0,2,2,2,0,2,0,2,0,0,2,0,2,0,2,0,2,0,0,2,0,2,0,0,0,0,0,0,0,2,0,2,0,0,2,0,0,0,0,2,0,1},
{1,0,0,2,2,2,2,2,0,0,2,0,0,2,0,2,0,2,2,0,0,0,2,0,2,2,2,2,0,2,2,2,2,2,2,0,2,2,0,2,2,2,0,0,2,2,2,2,0,1},
{1,0,2,2,2,2,0,0,0,2,2,0,2,2,0,2,2,2,2,2,0,2,2,0,0,0,2,0,0,0,2,0,0,0,2,0,2,0,0,0,2,0,0,2,0,0,0,2,0,1},
{4,0,0,0,0,0,0,2,0,0,2,0,0,0,0,0,0,0,0,0,0,0,0,2,2,0,0,0,2,0,0,0,2,0,0,0,2,0,2,0,0,0,2,2,0,2,0,0,0,1},
{1,1,1,1,1,1,1,1,1,1,1,1,1,1,1,1,1,1,1,1,1,1,1,1,1,1,1,1,1,1,1,1,1,1,1,1,1,1,1,1,1,1,1,1,1,1,1,1,1,1},

//7
{1,1,1,1,1,1,1,1,1,1,1,1,1,1,1,1,1,1,1,1,1,1,1,1,1,1,1,1,1,1,1,1,1,1,1,1,1,1,1,1,1,1,1,1,1,1,1,1,1,1,1,1,1,1,1,1,1,1,1,1},
{1,3,0,2,0,0,0,0,0,2,0,0,0,2,0,0,0,0,0,0,2,0,0,0,0,2,0,0,2,0,2,0,0,0,0,0,2,0,2,0,2,0,2,0,2,0,0,0,2,0,0,2,0,0,0,0,0,0,0,1},
{1,2,0,2,2,0,2,2,0,0,0,2,0,0,2,2,0,2,2,0,0,0,2,2,0,2,2,0,2,0,0,0,2,2,2,0,0,0,2,0,0,0,2,0,0,0,2,0,0,0,2,2,0,2,0,2,2,2,0,1},
{1,2,0,2,0,0,0,2,2,2,2,2,2,0,2,0,0,2,0,2,2,2,2,0,0,2,0,0,0,0,2,0,2,2,2,2,2,0,2,0,2,2,0,0,2,0,2,2,2,0,0,0,0,2,0,0,0,2,2,1},
{1,0,0,2,0,2,0,0,0,2,0,0,0,0,0,0,2,2,0,2,2,0,0,0,2,2,0,2,2,0,2,0,2,2,2,0,0,0,0,0,2,0,0,2,2,0,0,0,2,0,2,2,2,2,2,2,0,0,0,1},
{1,0,2,2,0,2,2,2,0,0,2,2,2,2,2,2,2,2,0,0,0,0,2,2,2,2,0,2,0,0,2,0,0,2,0,0,2,2,0,2,2,0,2,2,2,2,2,2,2,0,2,0,2,0,0,2,2,2,0,1},
{1,0,0,2,0,0,0,0,2,0,0,2,0,0,0,0,0,0,0,2,2,2,2,0,0,0,0,2,2,2,2,2,0,2,2,2,2,0,0,2,0,0,2,2,2,0,0,0,2,0,0,0,2,0,2,2,0,0,0,1},
{1,2,0,0,2,2,2,2,2,2,0,0,2,2,2,2,2,2,0,0,0,2,2,0,2,2,2,0,0,0,2,0,0,0,0,2,0,0,2,0,0,2,0,2,0,0,2,0,0,2,2,0,2,0,2,0,0,2,0,1},
{1,0,2,0,2,2,0,0,0,2,2,0,2,0,2,0,0,0,2,2,0,0,2,2,2,0,0,0,2,0,2,2,2,2,0,2,0,2,2,0,2,2,0,2,0,2,2,2,0,2,2,0,0,0,2,0,2,2,0,1},
{1,0,2,0,0,0,0,2,0,0,2,0,2,0,0,0,2,2,2,2,2,0,0,0,2,2,0,2,2,0,0,0,2,2,0,2,0,0,2,0,0,0,0,2,0,2,0,0,0,0,2,2,2,2,2,0,2,2,0,1},
{1,0,2,2,2,2,2,2,2,0,0,0,2,2,2,0,0,0,0,0,2,2,2,0,2,0,0,2,2,2,2,0,0,2,0,2,2,2,2,2,2,0,2,2,0,2,2,0,2,0,0,0,0,0,2,0,0,0,2,1},
{1,0,0,0,2,0,0,0,2,2,2,2,0,0,0,0,2,2,2,0,0,0,2,0,0,0,2,2,0,0,0,2,0,2,0,0,0,0,0,2,2,0,2,2,0,0,2,2,2,2,2,2,2,0,2,2,2,0,0,1},
{1,0,2,0,0,0,2,0,0,0,0,2,2,2,2,2,2,0,0,0,2,0,2,2,2,2,2,2,0,2,0,2,0,0,2,2,0,2,2,0,0,0,0,0,2,0,0,2,0,0,0,2,0,0,0,2,2,2,0,1},
{1,0,2,2,2,2,2,2,2,2,0,0,0,2,0,0,0,0,2,2,2,0,2,0,0,0,0,0,0,2,0,2,2,0,2,2,0,0,0,0,2,2,2,0,2,2,0,0,0,2,0,2,2,2,0,2,0,0,0,1},
{1,0,0,0,0,0,0,0,2,0,0,2,0,0,0,2,2,2,0,0,0,0,2,0,2,0,2,2,0,2,0,0,2,0,0,2,2,2,2,0,2,0,2,2,2,2,2,2,2,2,0,2,0,0,0,0,0,2,0,1},
{1,2,0,2,2,2,2,2,0,0,2,2,0,2,2,0,0,0,0,2,2,0,2,2,2,0,0,2,0,2,2,0,2,2,0,0,2,2,2,0,2,0,0,0,0,0,2,2,0,0,0,2,2,2,2,2,2,2,0,1},
{1,0,0,2,0,0,0,2,0,2,2,0,0,0,2,2,2,2,2,2,0,0,0,0,2,2,2,2,0,2,2,0,0,0,2,0,0,2,0,0,2,2,0,2,2,0,0,2,0,2,2,2,2,0,0,0,0,0,0,1},
{1,0,2,0,0,2,0,2,0,2,2,0,2,2,2,0,0,0,0,2,2,2,2,0,0,0,2,0,0,0,2,0,2,2,2,2,0,2,2,2,0,0,0,2,0,2,0,0,0,2,0,0,0,0,2,2,2,2,2,1},
{1,0,2,0,2,2,0,2,0,0,2,0,0,0,2,0,2,2,0,2,0,0,0,2,2,0,2,0,2,0,2,0,0,2,0,0,0,2,0,0,0,2,2,2,0,2,2,2,2,2,0,2,2,2,0,0,0,0,0,4},
{1,2,2,0,2,0,0,2,2,0,2,2,2,2,2,0,2,0,0,2,0,2,2,2,2,0,2,0,2,0,2,0,2,2,0,2,2,2,2,0,2,2,0,2,0,2,0,0,0,2,0,0,2,2,0,2,2,2,2,1},
{1,0,0,0,2,0,2,2,0,0,2,2,0,0,0,0,2,0,2,2,0,0,0,2,0,0,2,0,2,0,2,0,2,0,0,2,0,0,0,0,2,0,0,2,0,0,0,2,0,2,2,0,2,0,0,0,0,0,0,1},
{1,0,2,2,2,0,2,2,0,2,2,0,0,2,2,2,2,0,0,0,2,2,0,0,0,2,2,2,0,0,2,0,2,0,2,2,2,2,0,2,2,2,0,0,0,2,2,2,0,2,2,0,2,2,2,2,2,2,0,1},
{1,0,0,2,0,0,0,0,0,2,0,0,2,2,0,0,0,2,2,0,0,2,0,2,2,2,0,0,0,2,2,2,0,0,2,0,0,0,0,2,2,0,0,2,2,2,0,2,0,0,2,0,0,0,0,2,2,2,0,1},
{1,2,0,2,0,2,0,2,2,0,0,2,0,0,0,2,2,2,2,2,0,2,0,0,0,0,0,2,0,2,2,0,0,2,2,2,0,2,2,2,0,0,2,0,0,0,0,2,2,0,2,2,2,2,0,0,2,0,0,1},
{1,2,0,2,2,2,0,2,0,0,2,2,2,2,0,0,0,0,0,2,0,0,2,2,2,2,0,2,2,2,0,0,2,0,0,0,0,2,0,0,0,2,2,0,2,2,0,2,2,0,0,0,2,2,2,0,0,0,2,1},
{1,2,0,0,0,2,2,2,0,2,2,0,0,0,0,2,0,2,2,2,2,0,0,0,2,2,0,2,0,0,0,2,2,0,2,0,2,2,0,2,2,2,2,2,2,2,0,2,0,0,2,0,0,0,0,2,2,0,0,1},
{1,2,0,2,0,0,0,2,0,0,0,2,2,2,2,2,0,0,0,0,0,2,2,0,0,0,2,2,0,2,2,2,2,2,2,0,2,0,0,0,0,0,0,2,0,0,0,2,2,2,2,2,2,2,0,2,2,2,0,1},
{1,0,0,2,0,2,0,0,0,2,0,0,2,2,0,0,0,2,2,2,0,0,0,2,2,0,2,0,0,0,2,2,2,0,0,0,2,2,2,2,2,2,0,2,0,2,0,0,2,2,0,0,0,2,0,0,0,2,0,1},
{1,0,2,2,0,2,0,2,0,2,2,0,0,0,0,2,2,0,0,0,0,2,0,0,2,0,0,0,2,0,0,0,0,0,2,2,0,0,0,0,0,0,0,0,0,2,2,0,0,0,0,2,0,2,0,2,0,0,0,1},
{1,1,1,1,1,1,1,1,1,1,1,1,1,1,1,1,1,1,1,1,1,1,1,1,1,1,1,1,1,1,1,1,1,1,1,1,1,1,1,1,1,1,1,1,1,1,1,1,1,1,1,1,1,1,1,1,1,1,1,1}





















//empty
{1,1,1,1,1,1,1,1,1,1,1,1,1,1,1,1,1,1,1,1},
{1,0,0,0,0,0,0,0,0,0,0,0,0,0,0,0,0,0,0,1},
{1,0,0,0,0,0,0,0,0,0,0,0,0,0,0,0,0,0,0,1},
{1,0,0,0,0,0,0,0,0,0,0,0,0,0,0,0,0,0,0,1},
{1,0,0,0,0,0,0,0,0,0,0,0,0,0,0,0,0,0,0,1},
{1,0,0,0,0,0,0,0,0,0,0,0,0,0,0,0,0,0,0,1},
{1,0,0,0,0,0,0,0,0,0,0,0,0,0,0,0,0,0,0,1},
{1,0,0,0,0,0,0,0,0,0,0,0,0,0,0,0,0,0,0,1},
{1,0,0,0,0,0,0,0,0,0,0,0,0,0,0,0,0,0,0,1},
{1,1,1,1,1,1,1,1,1,1,1,1,1,1,1,1,1,1,1,1}

//background
{1,1,1,1,1,1,1,1,1,1,1,1,1,1,1,1,1,1,1,1,1,1,1,1,1,1,1,1,1,1,1,1,1,1,1,1,1,1,1,1},
{1,2,2,0,2,2,2,2,2,2,2,2,2,2,2,0,2,2,2,2,0,2,2,2,2,2,2,2,2,0,0,2,2,2,2,0,0,2,2,1},
{1,0,2,2,0,0,0,0,0,0,0,2,0,0,2,2,2,0,0,2,0,0,0,0,2,0,0,0,2,2,0,2,0,0,2,2,2,2,0,1},
{1,2,0,2,0,2,2,2,2,0,2,2,0,0,0,0,0,0,2,2,0,2,2,2,2,0,0,0,0,2,0,0,0,2,2,0,0,2,0,1},
{1,2,0,2,0,0,2,0,2,2,2,0,2,2,2,0,2,0,2,0,0,2,0,0,0,2,2,2,2,2,2,2,2,2,0,2,2,2,2,1},
{1,2,0,2,2,0,0,0,2,0,0,0,2,0,2,2,2,0,2,2,0,2,2,2,0,0,0,0,0,0,0,0,0,0,0,0,0,0,2,1},
{1,2,0,0,2,2,0,2,2,0,2,2,2,0,0,2,0,0,0,2,2,0,0,2,2,2,2,2,2,2,0,2,2,2,2,2,2,0,2,1},
{1,2,0,2,0,2,2,2,0,0,2,0,0,0,0,2,2,2,2,0,2,2,0,0,0,0,0,2,0,2,0,2,0,0,2,0,0,2,2,1},
{1,2,0,2,0,0,0,0,2,2,2,0,2,2,2,0,0,0,0,0,0,2,2,2,2,0,0,2,0,2,0,2,0,2,2,0,2,2,0,1},
{1,2,0,2,2,2,0,2,2,0,2,0,2,0,2,0,0,2,2,2,0,0,0,0,2,2,0,2,0,2,0,2,0,2,0,0,2,0,2,1},
{1,2,0,0,0,2,2,2,0,0,2,0,2,0,2,2,2,2,0,2,2,2,0,0,0,2,2,0,0,2,0,2,0,2,0,0,2,0,2,1},
{1,2,2,2,2,2,0,0,0,0,2,2,2,0,0,0,0,0,0,2,0,2,2,2,2,0,2,0,0,2,0,0,0,2,0,2,2,0,2,1},
{1,0,0,2,0,0,0,2,2,2,0,0,0,2,2,2,2,0,2,2,0,2,0,0,2,0,2,0,2,2,2,0,2,2,0,2,0,0,2,1},
{1,0,2,2,0,2,0,2,0,0,0,2,2,2,0,0,2,0,2,0,0,0,0,2,2,0,2,0,0,0,2,0,2,0,0,2,0,0,2,1},
{1,2,2,0,0,2,2,2,0,2,2,2,0,0,0,0,2,0,2,2,2,0,2,2,0,0,2,2,0,0,2,0,2,2,0,2,0,2,2,1},
{1,2,0,0,0,2,0,0,2,2,0,0,2,2,2,2,2,0,0,0,0,2,2,0,0,2,0,2,0,2,2,0,0,2,0,2,2,2,0,1},
{1,2,2,2,2,2,0,0,2,0,2,2,2,0,0,0,0,0,0,2,2,2,0,0,0,2,0,2,2,2,0,0,0,2,0,0,0,2,2,1},
{1,0,0,2,0,2,2,0,2,0,2,0,0,0,0,2,2,2,2,2,0,2,2,0,0,2,0,0,0,0,0,2,2,2,2,2,0,0,2,1},
{1,2,3,2,0,0,4,0,2,0,2,2,2,0,2,2,0,0,0,0,0,0,2,0,2,2,2,0,0,2,0,2,0,0,0,2,2,0,2,1},
{1,1,1,1,1,1,1,1,1,1,1,1,1,1,1,1,1,1,1,1,1,1,1,1,1,1,1,1,1,1,1,1,1,1,1,1,1,1,1,1}



  0 = air
  1 = outer wall
  2 = inner wall
  3 = spawn
  4 = goal